{
  "width": 13,
  "height": 11,
  "grid": [
    "#####--####",
    "#---####--###",
    "#-----#-----#",
    "##.##*$$$$--#",
    "##.##.-$@####",
    "#-....-$--#",
    "#-.##*$$$$##",
    "#-.--.#----#",
    "#--##------#",
    "#--#########",
    "####"
  ]
}