{
  "width": 19,
  "height": 21,
  "grid": [
    "-##################",
    "-#--#----#--#-----#",
    "-#-$--$$-$$-#$-$$-#",
    "##..#$-$##..#-$-$-#",
    "#-..#---$-..#$-$--#",
    "#-#..#--#...#-$-$-#",
    "#-#..#$$-..##--$--#",
    "#--#..-#..###-$-$-#",
    "##-$..##..#---#-$-#",
    "#--##....-#-$-#-$-#",
    "#--##....##-$--#--#",
    "#---##..-$-#--$-#-#",
    "#---##..#-$-#-$-$-#",
    "#---##..#--$-#-$.-#",
    "#---##..#$--$-#...#",
    "#-#-##..#--$-$-#.##",
    "#-----..#$@-$-$---#",
    "#----#--#-$$-$-$$-#",
    "#-------#$--$$--$-#",
    "#####--##---------#",
    "----###############"
  ]
}