{
  "width": 24,
  "height": 27,
  "grid": [
    "##############",
    "#-------#----#####",
    "#@$-$-$-$-$-$##--#######",
    "#-###-$$-$-$-$-------$-#",
    "#--####------##...#$$$-#",
    "##---#########**.**----#",
    "#--$--##-#----**.***---#",
    "#-$-$-#--##...-..-***-##",
    "#-$-$-#---.....#....*$##",
    "#-$-$-##-**....##--.$--#",
    "#-$-$$##-***...-...#$$-#",
    "#-$$---**-*#$-$.**..---#",
    "#-$---#*.*-.***-**..*-##",
    "#-$$$**..#..*.**#.***-#",
    "#-$--**..#.##.**#-***$##",
    "#-$-$***..-..-*#..-*-$-#",
    "#-$--****-....-...*#---#",
    "#-$-$---#**....-**..-$-#",
    "#-$-$-$--**..#--***.-$-#",
    "#-$-$-$--***-..-***.-$-#",
    "#-$-$-$-#-*-.*..-..--$-#",
    "#-$-$-$-$--$**...##$-$-#",
    "#-$----$----**.**-$--$-#",
    "#-$$$$$$$$$#**.**-$$$$-#",
    "#--$-$-$-#---...--#----#",
    "##-------####---########",
    "-#########--#####"
  ]
}