{
  "width": 21,
  "height": 10,
  "grid": [
    "-######-############",
    "##----#-#----------#",
    "#--.**###**-#*-.**.#",
    "#-.$#-*@*--*-*-$--.##",
    "#-#---*#*--*-*-$$$.-#",
    "#-#.**--*-#*-*-$-.$-#",
    "#-.$----*--*-*-$.-$-#",
    "#-.****##**#-*#.$$--#",
    "##-----##----------##",
    "-###################"
  ]
}