{
  "width": 34,
  "height": 19,
  "grid": [
    "-------####--------###############",
    "-#######--##########---------##--#",
    "-#.---.#....--..#----.##..-#-..--#",
    "-#..-..-.-##-.--.-#-..-.--.#.-#.-#",
    "-#.#.#.#.####.##.---#.#.#-.-.-#.-#",
    "-#.#-#.#...---..-##.#.#.##.#.-#.-#",
    "-#.--#.#.#---.##.#--#.#.##.#.--.-#",
    "-#.###.#.#---.-#.--#-.-.##.#.-#.##",
    "-#.---.-.--##-..-----.--..-##..##",
    "#####-####-###-##-#######-####-###",
    "#-$---$-$---#-$$--#--$--$$---$$--#",
    "#-$-#-$-$-#--$--$#---$-$--$-$#-$-#",
    "#-$-#-$-$-#--$--$--#-$-$-#$-$--$-#",
    "#-$-#-$-$$$-#-$$##-$-$-$--$-$--$-#",
    "#-$-$-$-$---#$--$-#--$-$--$-$-#$-#",
    "#-$$-$$-$--#-$--$--#$$-$--$-$--$-#",
    "#-$---$-$$$$-#$$-#---$-#$$---$$###",
    "#------------#---#-@-#-----#---#",
    "################################"
  ]
}