{
  "width": 13,
  "height": 27,
  "grid": [
    "#############",
    "#----####---#",
    "#--#------#-#",
    "#--#-#.##-#-#",
    "#--.-#.##.#-#",
    "#--#.-.#.---#",
    "#--##...-#-##",
    "#-....#....-#",
    "#----...##--#",
    "#-#-.#.-.#--#",
    "#--.-#.#-.--#",
    "#---##.#----#",
    "#----#-#----#",
    "#----#-#----#",
    "######$######",
    "#---$-------#",
    "#--$-$$#$#--#",
    "##--$----#$-#",
    "##$#-$##$#-##",
    "##--$--@-$-##",
    "#-$-$$$##---#",
    "#-#$-----#$-#",
    "#-#--$#$----#",
    "#-$$$-$--#$-#",
    "#-$----$-#--#",
    "#----#---####",
    "#############"
  ]
}