{
  "width": 7,
  "height": 14,
  "grid": [
    "-#####",
    "##---##",
    "#--#.-#",
    "#-$#*-#",
    "#--#.-#",
    "#-$#*-#",
    "#--#.-#",
    "#-$-*-#",
    "#-##.-#",
    "#-$-*-#",
    "#--#.-#",
    "##-$-##",
    "-#-@-#",
    "-#####"
  ]
}