{
  "width": 14,
  "height": 10,
  "grid": [
    "####-#######",
    "#..#-#-----###",
    "#..###-$--$--#",
    "#...-#$####--#",
    "#...-$-@-##--#",
    "#..$-#-#--$-##",
    "######-##$-$-#",
    "--#-$--$-$-$-#",
    "--#----#-----#",
    "--############"
  ]
}