{
  "width": 13,
  "height": 8,
  "grid": [
    "#############",
    "#---######--#",
    "#--------$--#",
    "##-#######--#",
    "#--$-$-$-#$##",
    "#--#....+---#",
    "#--######---#",
    "#############"
  ]
}