{
  "width": 10,
  "height": 7,
  "grid": [
    "##########",
    "#--------#",
    "#-*.*.*..#",
    "##$####-##",
    "#--$@$-$-#",
    "#--------#",
    "##########"
  ]
}