{
  "width": 11,
  "height": 6,
  "grid": [
    "###########",
    "#----#----#",
    "#-.*-$-*.-#",
    "#-$**#**$-#",
    "#----+----#",
    "###########"
  ]
}