{
  "width": 18,
  "height": 11,
  "grid": [
    "-#############",
    "-#------##---#####",
    "##$#--$-##--$----#",
    "#----$##---##-$$-#",
    "#-###----$-$-##--#",
    "#...#--###---##$-#",
    "#...#$$###-$###@-#",
    "#...#-----$-#-####",
    "#...$-$##--##",
    "#...---#####",
    "########"
  ]
}