{
  "width": 10,
  "height": 12,
  "grid": [
    "##########",
    "#--------#",
    "#-$-$$#$-#",
    "#-#----$-#",
    "#--####$##",
    "#---...--#",
    "##$#.#.#-#",
    "#-$-...#-#",
    "#-#--#---#",
    "#@----####",
    "###---#",
    "--#####"
  ]
}