{
  "width": 15,
  "height": 14,
  "grid": [
    "-#####-#####",
    "##---###---###",
    "#--$$--..#---#",
    "#-$-##.--.-#-#",
    "#-$---.##.-#-#",
    "#-$$$-#...-#-#",
    "#-$--$--#.-#-#",
    "#-$-@$-##.---##",
    "#-#$$#-..-#---#",
    "#------#-##-#-#",
    "########------#",
    "-------#-###-##",
    "-------#-----#",
    "-------#######"
  ]
}