{
  "width": 7,
  "height": 10,
  "grid": [
    "#####",
    "#---###",
    "#-.$.-#",
    "##$*$-#",
    "#-.*.-#",
    "#--*--#",
    "##-*--#",
    "-#-$-##",
    "-##@-#",
    "--####"
  ]
}