{
  "width": 11,
  "height": 14,
  "grid": [
    "---#####",
    "####-@-####",
    "#----$----#",
    "#-#$#$#$#-#",
    "#-$.....$-#",
    "#-#.###.#-#",
    "#-$.#-#.$-#",
    "#-#.###.#-#",
    "#-$.....$-#",
    "#-#$$#$$#-#",
    "#--$-#-$--#",
    "###--#--###",
    "--#-----#",
    "--#######"
  ]
}