{
  "width": 11,
  "height": 8,
  "grid": [
    "###########",
    "#-.-.-.---#",
    "#-$*-.$---#",
    "##-#####-##",
    "#--#---#-#",
    "#--$-$@--#",
    "#--#######",
    "####"
  ]
}