{
  "width": 14,
  "height": 15,
  "grid": [
    "------######",
    "------#----#",
    "------#--#-#",
    "#######....#",
    "#-----#--#.#",
    "#--#--##-#.##",
    "#-$$$$---.--#",
    "#----$-#.##-#",
    "####-$-#.##-#",
    "##--$-#-.---##",
    "#-@$-#---#---#",
    "#-#$---#---#-#",
    "#--$--####---#",
    "##--###--#####",
    "-####"
  ]
}