{
  "width": 11,
  "height": 17,
  "grid": [
    "--#####",
    "-##---#",
    "-#----##",
    "##-***-###",
    "#-*#--*--#",
    "#-*-@#*--#",
    "#-*#$*---#",
    "#-*--#*####",
    "#-*#---*--#",
    "#-*--#-*--#",
    "#-*#---*-##",
    "#-*-***--#",
    "#-*#---###",
    "#-.#----#",
    "#---###-#",
    "###-----#",
    "--#######"
  ]
}