{
  "width": 10,
  "height": 8,
  "grid": [
    "---####",
    "####--####",
    "#-$-.*-$-#",
    "#-#-**-#-#",
    "#-#-..-#-#",
    "#---##$--#",
    "###--@-###",
    "--######"
  ]
}