{
  "width": 29,
  "height": 18,
  "grid": [
    "----------#####",
    "---########---#--#####-#####",
    "####------#---####---###---#",
    "#--***-#--#***-##-*----***-##",
    "#-*---*#--*---*---*-#-*#--*-#",
    "#-.-#-*-#-*-#-*-#-*-#-*@--*-#",
    "#-#-#**-#-*---*-#-*-#-#***--#",
    "#-***---#-*###*-#-*-#-$---*-#",
    "#-*---.-#-*---*-#-*--#$#--*-#",
    "#-*****-#--***--#-*--#-***--#",
    "##---#-##--#-###---##--#---##",
    "-##--#-##--#-###---#--######",
    "--#-#--#####-###--#--##",
    "--#-#-----------##--##",
    "--#-#--#-######----##",
    "--#--##--#----######",
    "--##----##",
    "---######"
  ]
}