{
  "width": 18,
  "height": 13,
  "grid": [
    "-----#####",
    "---###---#",
    "---#---#-#",
    "---#-#---#",
    "####--##$########",
    "#---#$--$-#-----##",
    "#---$-#$#-#-#-#--#",
    "#-#-#-#---#....--#",
    "#-$---##-$@--#.--#",
    "#-#-#$##-##....--#",
    "#---$----##-#-#--#",
    "######---##-----##",
    "-----############"
  ]
}