{
  "width": 12,
  "height": 11,
  "grid": [
    "############",
    "#-------#--#",
    "#-$-$---$$-#",
    "#-####-#-$-#",
    "#$$--#$#-$-#",
    "#-##-#-#$--#",
    "#-##-$-$---#",
    "#....--#---#",
    "#....@######",
    "#....##",
    "######"
  ]
}