{
  "width": 14,
  "height": 16,
  "grid": [
    "####",
    "#--######",
    "#--##---#####",
    "#---#-------##",
    "##--****###--#",
    "-#-*#--@*--#-#",
    "##*-####-*---#",
    "#--*----#-####",
    "#---***.#$--#",
    "##-*----#---#",
    "##*-####-*--#",
    "#--*----*--##",
    "#--#****---#",
    "#--#----#--#",
    "####--######",
    "---####"
  ]
}