{
  "width": 16,
  "height": 10,
  "grid": [
    "###########-----",
    "#---------###---",
    "#-###-$$----#---",
    "#---#-$--$--#---",
    "##-$####$####---",
    "#-$-##---#--####",
    "#--$$-$----....#",
    "###-##-$$#-....#",
    "--#--@---##....#",
    "--##############"
  ]
}