{
  "width": 18,
  "height": 9,
  "grid": [
    "--########",
    "###---#--#########",
    "#-$$$----#...-#--#",
    "#-@-$-#---.#-----#",
    "###$$--###..--#--#",
    "--#-$--###.####--#",
    "--#-$-##--.------#",
    "--#------##---#--#",
    "--################"
  ]
}