{
  "width": 17,
  "height": 6,
  "grid": [
    "-----####",
    "######--#########",
    "#---$-*..$------#",
    "#-#-#$.*.$#-#-#-#",
    "#---$@*..$------#",
    "#################"
  ]
}