{
  "width": 10,
  "height": 11,
  "grid": [
    "########",
    "#---#--##",
    "#-#-#---##",
    "#---**#--#",
    "#-#*--*--#",
    "#--.##$#@#",
    "#-#*--*--#",
    "#-#-**---#",
    "#--#--#--#",
    "##---#####",
    "-#####"
  ]
}