{
  "width": 15,
  "height": 9,
  "grid": [
    "###############",
    "#-------------#",
    "#-$$$$#-#$$$$-#",
    "##-----------##",
    "-######@#######",
    "##-....-....--#",
    "#-------------#",
    "#---########--#",
    "#####------####"
  ]
}