{
  "width": 9,
  "height": 11,
  "grid": [
    "--#####",
    "-##-@-##",
    "##-$$$-##",
    "#-$-.-$-#",
    "#-.***.-#",
    "#-*-.-$-#",
    "#-*****-#",
    "#-$-.-*-#",
    "#-.***.-#",
    "#---*---#",
    "#########"
  ]
}