{
  "width": 9,
  "height": 7,
  "grid": [
    "#########",
    "#--.-.--#",
    "#--$-$--#",
    "##*****##",
    "#--$-$--#",
    "#--.@.--#",
    "#########"
  ]
}