{
  "width": 14,
  "height": 9,
  "grid": [
    "####",
    "#--###########",
    "#----$-$-$-$-#",
    "#--#.-.-.-.--#",
    "##-########-##",
    "#--.-.-.-.#--#",
    "#-$-$-$-$----#",
    "###########-@#",
    "----------####"
  ]
}