{
  "width": 14,
  "height": 13,
  "grid": [
    "----#####",
    "--###---######",
    "###---#------#",
    "#---#-#.###--#",
    "#-#-#-..--#$-#",
    "#---#.###-$-##",
    "#-#-..--#$#-#",
    "#-#.###-$-$-#",
    "#-..--#$-$--#",
    "#-#-#-$-$#-@#",
    "#---#----####",
    "#####--###",
    "----####"
  ]
}