{
  "width": 27,
  "height": 11,
  "grid": [
    "---------------------######",
    "########################--#",
    "#------#######---#######--#",
    "#--$-$$#---###-#-#---###--#",
    "#-#-$--#....-----#....---##",
    "#-$$-$$##--###-####--##---#",
    "#-#-$--##-####--###-###---#",
    "#--$-$$-----#....-----#---#",
    "#-##-#-##-#-#---###-#-##--#",
    "#@-----##---#######---##--#",
    "###########################"
  ]
}