{
  "width": 25,
  "height": 21,
  "grid": [
    "--------#########",
    "----#####---#---###",
    "----#-----#-#-#---###",
    "---##-###$$$$$$$#---##",
    "--##----$-#---#-$-#--####",
    "###--#-$---$$$--#$-#----#",
    "#---##$#-#$$-$$-#-$####-#",
    "#.#--*-.....#.....-*....#",
    "#.--#*-.$-#.#.##$.#*#-#.#",
    "#.##-*-*$-#.#.#-$$-*--#-#",
    "#-...$-*-##.@-...$-*#-#-#",
    "#-#.#$#**...#-##$*-*----#",
    "#-#.-$-.$##.#.#-$.#*###.#",
    "#-#.-$#.--#.#.....-*....#",
    "#--#--$---$$-$$-#-$####-#",
    "##-#-##$#--$$$--#$--#---#",
    "-#-#----$-#---#-$---#-###",
    "-#--#####$$$$$$$####--#",
    "-##-------#-#-#------##",
    "--#######-------######",
    "--------#########"
  ]
}