{
  "width": 31,
  "height": 21,
  "grid": [
    "--#############################",
    "--#---------------------------#",
    "--#-#-#-#-#-#-#-#-#-#-#-#-#-#-#",
    "--#-$$$$$$$$$-$$$$$$$$$$$$$$$-#",
    "--#-$-$-$-$--#----$-$-$-$-$-$-#",
    "--#-$-$-$---$$-#-$--$-$-$-$-$-#",
    "--#-$----#-$--$###$-----------#",
    "--#--$-$-$$$-$-#--$$$--$-$-$--#",
    "--#-$-$-$--$---#----#-$-$-$-$-#",
    "###########-#####-#########-###",
    "#----######-----#-########--###",
    "#-.#-#.-...#..--#-#-..---..#--#",
    "#-..-..-.#-.--.##-#.##.-.##.--#",
    "#-.-.#.#.-#.##.##-#.##.#.##.--#",
    "#-.--#.-..--..------..---..---#",
    "#-.--#.#.--.-#.##-#.##.#.##.-##",
    "#-.--#.#.--.-#.##-#.##.-.--.-#",
    "#-.---.#.---..----#-..---..###",
    "##--------@-#######--#######",
    "-#######--###-----####",
    "-------####"
  ]
}