{
  "width": 46,
  "height": 11,
  "grid": [
    "#######------####---####-####-------####-####",
    "#-----########--###-#--#-#--#########--###--##",
    "#-#**-#---#--#----###--###--#---#--------#---#",
    "#-*--*#-#**--#*--*#--**---***---#**-#-*--*-*-#",
    "#--*----*-#*--*-*-#-*--*--*--*#-*--*--**-*-*-#",
    "#-#-*-##*@-*--**--#-*-#*#-***---*--*#-*-**-*-#",
    "#-.-#*#-*--*##*-*-#-*--*--*--*#-****--*--*-$-#",
    "##-**-#--**-#-*--*---**--#***---*--*--*#-*-*-#",
    "-#----#----------####-------##--#----#-------#",
    "-#################--#####################--###",
    "----------------------------------------####"
  ]
}