{
  "width": 9,
  "height": 14,
  "grid": [
    "-########",
    "##--##--#",
    "#.....--#",
    "#-#.-#--#",
    "#-#.-#--#",
    "#-#.---##",
    "#--.-###",
    "####$####",
    "#---$---#",
    "#-#-$#--#",
    "#-#-$---#",
    "#-$$$$$##",
    "#---@--#",
    "########"
  ]
}