{
  "width": 35,
  "height": 10,
  "grid": [
    "###################################",
    "#-...--.--.-.--.--..---.--.---.-.-#",
    "#-*$$-.$.-*-*#.$.-*$.-.$.-*.##*-*-#",
    "#-*..-*-*-*.$-*-*-*.$-*.*-*$.-*-*-#",
    "#-$$*-*-*-*$.-*-*-*$.-*$*-*-$.*#$-#",
    "#-..*-$.$-*-*-$.$-*.$-*-*-*--$*-.-#",
    "##$$$#-$--$-$--$-#$$--$-$-$---$-$-#",
    "-#-#-######-######-####-###########",
    "-#@---------------------#",
    "-########################"
  ]
}