{
  "width": 10,
  "height": 14,
  "grid": [
    "-----####",
    "-----#--#",
    "---###--#",
    "####----#",
    "#---**$##",
    "#-#.#-*-##",
    "#-#.#@$--#",
    "#--.**$#-#",
    "###*--*--#",
    "#--*--*#-#",
    "#-##**---#",
    "#------#-#",
    "######---#",
    "-----#####"
  ]
}