{
  "width": 20,
  "height": 15,
  "grid": [
    "####################",
    "#----##---#----#---#",
    "#--$--$-----##-$---#",
    "##-#####--.######-##",
    "-#-##--##....####-##",
    "##-##$-###..##-----#",
    "#------#...-.#-$-$-#",
    "#-$-##-##-.-###-####",
    "#-#-$----#.##-#-#---",
    "#-$-$-#---.####-##--",
    "#-#--##-#-##--#--##-",
    "#######--$##$---$-#-",
    "------##------$-#@#-",
    "-------#--##-######-",
    "-------#######----"
  ]
}