{
  "width": 31,
  "height": 11,
  "grid": [
    "###############################",
    "#-----#.---#.-###.---#--------#",
    "#-$$#-$..#-#..--$..--#-$$$$$$-#",
    "#-$---#...-$...-#...-#-$------#",
    "#-$$$-#....#....#....#-$$$$$$-#",
    "#-$---#...-$...-#...-#-$------#",
    "#-$$$-#..#-#..#-#..#-#-$$$$$$-#",
    "#-----$.---#.---#.---$--------#",
    "#-$$$-#$#########$####$$$$$$$-#",
    "#@------#########-------------#",
    "###############################"
  ]
}