{
  "width": 50,
  "height": 9,
  "grid": [
    "##################################################",
    "#------#----#----#----#----#----#---#--#-----#---#",
    "#-$***-#**--*--*-#**--***---**--*--*---***--*#-*-#",
    "#-*----*--*-*-*--*--*-*--*-*--*-**-*--#*--*-*-*--#",
    "#--**--*--*-**---*--*-***--*--*-*-**#--*--*-**---#",
    "#----*-*--*-*-*--*--*-*--*-****-*--*--#*--*-*-*--#",
    "#-***--#**--*--*-#**--***--*--*-*--*-*-***--*#-+-#",
    "#------#----#----#----#---------#--#---#-----#---#",
    "##################################################"
  ]
}