{
  "width": 20,
  "height": 21,
  "grid": [
    "--####",
    "--#--#########",
    "-##--#--#----#--####",
    "##--$$--#-#$-####--#",
    "#--$-#--#--$----#--#",
    "#-$-$-#-$---$-$-#--#",
    "#--$---$##$$#####-##",
    "#-$$$#-$------$----#",
    "#--$@#--#---$-##---#",
    "#---#########--#$###",
    "########----##-----#",
    "---##--#-##--#-#---#",
    "---#------.....#####",
    "---#-----#...#.####",
    "---#--#--#.....#--#",
    "---#####-#.##..---##",
    "------#--#.....#---#",
    "------#--##--###---#",
    "------#------#-##--#",
    "------###----#--####",
    "--------######"
  ]
}