{
  "width": 25,
  "height": 10,
  "grid": [
    "#########################",
    "#--.**.-*...$.***-..*.$-#",
    "#-.$-$-.$---*-$--*$-$-*-#",
    "#.$$-$*-*--.$.$-.-*-$-$.#",
    "#.$---*-*--.$.$-.-*-$-$.#",
    "#.$---*-*--.$.$-.-*-$-$.#",
    "#.$$$$*-*--.$.$-.-*-$-$.#",
    "#-*---$.$$--*-$--*$-$-+-#",
    "#-$...*-.***-.***-..*.$-#",
    "#########################"
  ]
}