{
  "width": 20,
  "height": 16,
  "grid": [
    "-###########--------",
    "-#-----#---##-------",
    "-#-$-$-$-#--#####---",
    "-###--#####-----#---",
    "-#....#-----###-#---",
    "-#.####--####---#---",
    "-#....----#--$-##---",
    "-#-...#---#-$$$#####",
    "###.#######--$@$---#",
    "#-$---#####-$-##---#",
    "#-#.#-$------$###$-#",
    "#-#.########--#--$-#",
    "#-#...-------##-$$-#",
    "#---#######-$-#-#--#",
    "#####-----#-------##",
    "----------#########-"
  ]
}