{
  "width": 9,
  "height": 9,
  "grid": [
    "######",
    "#----####",
    "#-$-.-$-#",
    "#-#$.$#-#",
    "#-..*..-#",
    "#-#$.$#-#",
    "#-$-+-$-#",
    "#####---#",
    "----#####"
  ]
}