{
  "width": 30,
  "height": 19,
  "grid": [
    "##############################",
    "#--------#-----#--###--#-----#",
    "#--$--$-$---$--#$-##-$-$$-$--#",
    "#-$$######$-#-$---#----#--#$-#",
    "#--------#--#--#-$----##--#--#",
    "#--$-$-$-#$-#$-#$-#$$-##-$#$-#",
    "#######$-#--#-----#----#--#--#",
    "#--$---$-#$-$--#$-##-$-$$$$--#",
    "#--#-----#-----#--###--#-----#",
    "#-.########################$##",
    "#.........-----##-----#--##--#",
    "#........#-$$-$-#--$$-$$--#$-#",
    "#........#--##-$---#--#--$#--#",
    "#........#-$$---#-$#$-#$-$---#",
    "#........#-$----#$--$-#--$$--#",
    "#........#-$##-$----$-#--#-$-#",
    "#........#--$-$-#$-#--$--#---#",
    "#........#----@##--#--#--##--#",
    "##############################"
  ]
}