{
  "width": 9,
  "height": 10,
  "grid": [
    "--#######",
    "--#-----#",
    "--#-----#",
    "###-##-##",
    "#@*--#-#",
    "##**-#-#",
    "#------#",
    "#-####-#",
    "#------#",
    "########"
  ]
}