{
  "width": 7,
  "height": 7,
  "grid": [
    "#######",
    "#--+--#",
    "#-***-#",
    "#-$.$-#",
    "#-$.$-#",
    "#--.--#",
    "#######"
  ]
}