{
  "width": 19,
  "height": 13,
  "grid": [
    "---#########",
    "--##---##--######",
    "###-----#--#----###",
    "#--$-#$-#--#--...-#",
    "#-#-$#@$##-#-#.#.-#",
    "#--#-#$--#----.-.-#",
    "#-$----$-#-#-#.#.-#",
    "#---##--##$-$-.-.-#",
    "#-$-#---#--#$#.#.-#",
    "##-$--$---$--$...-#",
    "-#$-######----##--#",
    "-#--#----##########",
    "-####"
  ]
}