{
  "width": 9,
  "height": 13,
  "grid": [
    "--#######",
    "###--#--#",
    "#----#--#",
    "#--$$$--#",
    "##$#-#$##",
    "#-*...*-#",
    "#-.--$.-#",
    "####$-#-#",
    "#-.-$-.-#",
    "#-#.#.###",
    "#---$---#",
    "##-@#---#",
    "-########"
  ]
}