{
  "width": 19,
  "height": 12,
  "grid": [
    "#################",
    "#---#---#---#---#",
    "#---$--$----#-$-#",
    "##$#-$####----$$###",
    "#--#--#..#--#$-$--#",
    "#--#$#....###-###-#",
    "#-$--#.....#----#-#",
    "##$--#.#...#$$-$-@#",
    "#--######..#-#--###",
    "#--$--------$-###",
    "#--######-----#",
    "####----#######"
  ]
}