{
  "width": 20,
  "height": 19,
  "grid": [
    "----------####",
    "-------####--#####",
    "-------#--#--#---#",
    "-------#--#------#",
    "-------#--##---###",
    "---######-.....#",
    "---#--#---.##-.#",
    "-###--#-##.###.#####",
    "##----#-##.#-#.#---#",
    "#--#-#--##.###.----#",
    "#-$$$$$-##.-#-.--###",
    "#-$---$-#-.....---#",
    "#-$-#-$##---####--#",
    "#-$-#-$------#-#-@#",
    "#-$-#-$####--#-####",
    "#-$---$-#-#--#",
    "#-$$$$$-#-####",
    "#-------#",
    "#########"
  ]
}