{
  "width": 26,
  "height": 16,
  "grid": [
    "---#######################",
    "####-----#---------------#",
    "#--#-###-#-######-######-#",
    "#----#---#-#--#----------#",
    "#--**--#-$**$-#--*##$**$##",
    "##*#-*-#-*--*-#-**-#.#-*-#",
    "-#---*-#-*--*--#-*-#.-@*-#",
    "##-#*##--*--*#---*-##.*--#",
    "#--*----#*#-*--#-*-#.$#.##",
    "#-*---##-*--*-##-*--*-#.#",
    "#-****-#-$**$-###*#-$..-##",
    "#-------------#-#----##--#",
    "#---#########-####-#-----#",
    "#####------#-------#---###",
    "-----------#---##--#####",
    "-----------#########"
  ]
}