{
  "width": 20,
  "height": 12,
  "grid": [
    "##############",
    "#--------#---#",
    "#-$$--#$$#-#-#######",
    "#--#-$-$-#$$-#-----#",
    "##-#--#--#-#-#--#--#",
    "#---##-------#$-+..#",
    "#-$-#-$-#$--#-$-#..#",
    "#-$-#$-#---#--$-#..#",
    "##$-#--####--$-#...#",
    "#--$----------#....#",
    "#---#######--#.....#",
    "#####-----##########"
  ]
}