{
  "width": 14,
  "height": 17,
  "grid": [
    "#####",
    "#---#",
    "#-#-#----####",
    "#---######--#",
    "###*--#@*---#",
    "-#-**-#-*-#-#",
    "##-*-*-#*-#-#",
    "#--*--*-*-#-#",
    "#-#*-#-**##-#",
    "#--*-#--*-#-#",
    "#-#--##---#-#",
    "#---###---#-#",
    "###-#-#--##-##",
    "--#-#######--#",
    "--#----------#",
    "--#--##---####",
    "--#########"
  ]
}