{
  "width": 17,
  "height": 9,
  "grid": [
    "------------#####",
    "#############---#",
    "#-$-$-$-$-$-$-#-#",
    "#-#-#-#-#-#-#-#-#",
    "#-#-------------#",
    "#-#-######-#-#-##",
    "#@.-.-.-.-.-.---#",
    "#########-------#",
    "--------#########"
  ]
}