{
  "width": 14,
  "height": 12,
  "grid": [
    "-#########",
    "-#-------#",
    "-#-$-$$-$#",
    "###-#--$-#",
    "#.#---$$-##",
    "#.###---$-#",
    "#.#.-$-##-####",
    "#...--$##-$--#",
    "#...$---$----#",
    "#..###$###-#@#",
    "#..#-#-----###",
    "####-#######"
  ]
}